WWWWWWWWWWW
WWWWWWWWWWW
WWFPFFFPFWW
WWFPFFFPFWW
WWFPFFFPFWW
WWFPFFFPFWW
WWFPFFFPFWW
WDFPFFFPFDW
WDFPFFFPFDW
WWFPFFFPFWW
WWFPFFFPFWW
WWFPFFFPFWW
WWFPFFFPFWW
WWFPFFFPFWW
WWWWWWWWWWW
WWWWWWWWWWW