WWWWWWWWWWW
WWWWWWWWWWW
WWFFPFFFFWW
WWFFPFFFFWW
WWFFPFFFFWW
WWFFPFFFFWW
WWFFPFFFFWW
WDFFPFFFFDW
WDFFPFFFFDW
WWFFPFFFFWW
WWFFPFFFFWW
WWFFPFFFFWW
WWFFPFFFFWW
WWFFPFFFFWW
WWWWWWWWWWW
WWWWWWWWWWW