WWWWWWWWWWW
WWWWWWWWWWW
WWBBBFFFFWW
WWBBBFFFFWW
WWBBFFFBFWW
WWBBFFFFFWW
WWBFFFFFFWW
WDFFFFFFFDW
WDFFFFFFFDW
WWBFFFFFFWW
WWBBFFFFFWW
WWBBFFFBFWW
WWBBBFFFFWW
WWBBBFFFFWW
WWWWWWWWWWW
WWWWWWWWWWW