WWWWWWWWWWW
WWWWWWWWWWW
WWFFFFFFFWW
WWFFFFFFFWW
WWFFFFFFFWW
WWFFFFFFFWW
WWFFFFFFFWW
WWFFFFFFFDW
WWFFFFFFFDW
WWFFFFFFFWW
WWBBFFFBBWW
WWBBBFBBBWW
WWBBBFBBBWW
WWBBBSBBBWW
WWWWWWWWWWW
WWWWWWWWWWW