WWWWWWWWWWW
WWWWWWWWWWW
WWFFFFFFFWW
WWFPPPPPPWW
WWFPPPPPPWW
WWFPPFFPPWW
WWFPPFFPPWW
WWFPPFFFFDW
WWFPPFFFFDW
WWFPPFFPPWW
WWFPPFFPPWW
WWFPPPPPPWW
WWFPPPPPPWW
WWFFFFFFFWW
WWWWDDDWWWW
WWWWWWWWWWW