WWWWWWWWWWW
WWWWWWWWWWW
WWFFFFFFFWW
WWFFFFFFFWW
WWFFFFFFFWW
WWFFFFFFFWW
WWFFFBFFFWW
WWFFBFBFFWW
WWFBFSFBFWW
WWFFBFBFFWW
WWFFFBFFFWW
WWFFFFFFFWW
WWFFFFFFFWW
WWFFFFFFFWW
WWWWDDDWWWW
WWWWWWWWWWW