WWWWWWWWWWW
WWWWDDDWWWW
WWFFFFFFFWW
WWFPPPPPFWW
WWFPFFFPFWW
WWFPFPFPFWW
WWFFFPFFFWW
WWFFFPFFFDW
WWFFFPFFFDW
WWFFFPFFFWW
WWFPFPFPFWW
WWFPFFFPFWW
WWFPPPPPFWW
WWFFFFFFFWW
WWWWDDDWWWW
WWWWWWWWWWW