WWWWWWWWWWW
WWWWDDDWWWW
WWFFFFFFFWW
WWFFFFFFFWW
WWFFFFFFFWW
WWFFFFFFFWW
WWFFFFFFFWW
WWFFFFFFFWW
WWFFFFFFFWW
WWFFFFFFFWW
WWBBFFFBBWW
WWBBBFBBBWW
WWBBBFBBBWW
WWBBBSBBBWW
WWWWWWWWWWW
WWWWWWWWWWW