WWWWWWWWWWW
WWWWDDDWWWW
WWPPPFPPPWW
WWPFFFFFPWW
WWPFPPPFPWW
WWPFPFPFPWW
WWPPPFPPPWW
WWFPFFFPFWW
WWFPFFFPFWW
WWPPPFPPPWW
WWPFPFPFPWW
WWPFPPPFPWW
WWPFFFFFPWW
WWPPPFPPPWW
WWWWWWWWWWW
WWWWWWWWWWW