WWWWWWWWWWW
WWWWDDDWWWW
WWFFFFFFFWW
WWFFFFFFFWW
WWFFFFFFFWW
WWFFFFFFFWW
WWFFFFFFFWW
WWFFFFFFFDW
WWFFFFFFFDW
WWFFFFFFFWW
WWFFFFFFFWW
WWFFFFFFFWW
WWFFFFFFFWW
WWFFFFFFFWW
WWWWWWWWWWW
WWWWWWWWWWW