WWWWWWWWWWW
WWWWDDDWWWW
WWFFFFFFFWW
WWFFFFFFFWW
WWFIFFFIFWW
WWFFFFFFFWW
WWFFFFFFFWW
WDFFFFFFFWW
WDFFFFFFFWW
WWFFFFFFFWW
WWFFFFFFFWW
WWFIFFFIFWW
WWFFFFFFFWW
WWFFFFFFFWW
WWWWWWWWWWW
WWWWWWWWWWW