WWWWWWWWWWW
WWWWDDDWWWW
WWFFFFFFFWW
WWFMFMFMFWW
WWFFFFFFFWW
WWFFFFFOOWW
WWFMFMFMOWW
WDFFFFOOODW
WDFFFFOOODW
WWFMFMFMOWW
WWFFFFFOOWW
WWFFFFFFFWW
WWFMFMFMFWW
WWFFFFFFFWW
WWWWWWWWWWW
WWWWWWWWWWW