WWWWWWWWWWW
WWWWWWWWWWW
WWFFFFFFFWW
WWFBFBFBFWW
WWFBFBFBFWW
WWFBFBFBFWW
WWFBFBFBFWW
WDFBFBFBFDW
WDFBFBFBFDW
WWFBFBFBFWW
WWFBFBFBFWW
WWFBFBFBFWW
WWFBFBFBFWW
WWFFFFFFFWW
WWWWWWWWWWW
WWWWWWWWWWW