WWWWWWWWWWW
WWWWDDDWWWW
WWFFFFFFFWW
WWFBFBFBFWW
WWFBFBFBFWW
WWFBFBFBFWW
WWFBFBFBFWW
WWFBFBFBFWW
WWFBFBFBFWW
WWFBFBFBFWW
WWFBFBFBFWW
WWFBFBFBFWW
WWFBFBFBFWW
WWFFFFFFFWW
WWWWDDDWWWW
WWWWWWWWWWW