WWWWWWWWWWW
WWWWWWWWWWW
WWFPFFFPFWW
WWFPFFFPFWW
WWFPFFFPFWW
WWFPFFFPFWW
WWFPFFFPFWW
WDFPFFFPFWW
WDFPFFFPFWW
WWFPFFFPFWW
WWFPFFFPFWW
WWFPFFFPFWW
WWFPFFFPFWW
WWFPFFFPFWW
WWWWWWWWWWW
WWWWWWWWWWW