WWWWWWWWWWW
WWWWWWWWWWW
WWPPPFPPPWW
WWPFFFFFPWW
WWPFPPPFPWW
WWPFPFPFPWW
WWPPPFPPPWW
WDFPFFFPFDW
WDFPFFFPFDW
WWPPPFPPPWW
WWPFPFPFPWW
WWPFPPPFPWW
WWPFFFFFPWW
WWPPPFPPPWW
WWWWWWWWWWW
WWWWWWWWWWW