WWWWWWWWWWW
WWWWWWWWWWW
WWOOOOOOOWW
WWOOOOOOOWW
WWOOOOOOOWW
WWOOOOOOOWW
WWOOOOOOOWW
WWOOOOOOODW
WWOOOOOOODW
WWOOOOOOOWW
WWOOOOOOOWW
WWOOOOOOOWW
WWOOOOOOOWW
WWOOOOOOOWW
WWWWWWWWWWW
WWWWWWWWWWW