WWWWWWWWWWW
WWWWWWWWWWW
WWFFFFFFIWW
WWFIFFFIFWW
WWIFFFIFFWW
WWFFFIFFFWW
WWFFIFFFFWW
WDFIFFFFFWW
WDFFFFFIFWW
WWFFFFIFFWW
WWFFFIFFFWW
WWFFIFFFIWW
WWFIFFFIFWW
WWIFFFFFFWW
WWWWDDDWWWW
WWWWWWWWWWW