WWWWWWWWWWW
WWWWWWWWWWW
WWFFFFFFFWW
WWFFFFFFFWW
WWFFFFFFFWW
WWFFFFFFFWW
WWFFFFFFFWW
WWFFBBBFFDW
WWFFBBBFFDW
WWFFFFFFFWW
WWFFFFFFFWW
WWFFFFFFFWW
WWFFFFFFFWW
WWFFFFFFFWW
WWWWWWWWWWW
WWWWWWWWWWW