WWWWWWWWWWW
WWWWWWWWWWW
WWFFFFFFFWW
WWFPPPPPFWW
WWFPFFFPFWW
WWFPFPFPFWW
WWFFFPFFFWW
WWFFFPFFFWW
WWFFFPFFFWW
WWFFFPFFFWW
WWFPFPFPFWW
WWFPFFFPFWW
WWFPPPPPFWW
WWFFFFFFFWW
WWWWDDDWWWW
WWWWWWWWWWW