WWWWWWWWWWW
WWWWWWWWWWW
WWBBBFFFFWW
WWBBBFFFFWW
WWBBFFFBFWW
WWBBFFFFFWW
WWBFFFFFFWW
WWFFFFFFFDW
WWFFFFFFFDW
WWBFFFFFFWW
WWBBFFFFFWW
WWBBFFFBFWW
WWBBBFFFFWW
WWBBBFFFFWW
WWWWDDDWWWW
WWWWWWWWWWW