WWWWWWWWWWW
WWWWDDDWWWW
WWFFFFFFFWW
WWFPPPPPPWW
WWFPPPPPPWW
WWFPPFFPPWW
WWFPPFFPPWW
WDFPPFFFFDW
WDFPPFFFFDW
WWFPPFFPPWW
WWFPPFFPPWW
WWFPPPPPPWW
WWFPPPPPPWW
WWFFFFFFFWW
WWWWWWWWWWW
WWWWWWWWWWW