WWWWWWWWWWW
WWWWWWWWWWW
WWFFPFFFFWW
WWFFPFFFFWW
WWFFPFFFFWW
WWFFPFFFFWW
WWFFPFFFFWW
WWFFPFFFFDW
WWFFPFFFFDW
WWFFPFFFFWW
WWFFPFFFFWW
WWFFPFFFFWW
WWFFPFFFFWW
WWFFPFFFFWW
WWWWDDDWWWW
WWWWWWWWWWW