WWWWWWWWWWW
WWWWWWWWWWW
WWPPPFPPPWW
WWPFFFFFPWW
WWPFPPPPPWW
WWPFFFFFPWW
WWPPPPPFPWW
WWFFFFPFFDW
WWFFPFFFFDW
WWPFPPPPPWW
WWPFFFFFPWW
WWPPPPPFPWW
WWPFFFFFPWW
WWPPPFPPPWW
WWWWDDDWWWW
WWWWWWWWWWW