WWWWWWWWWWW
WWWWWWWWWWW
WWFFFFFFFWW
WWFBFBFBFWW
WWFFFFFFFWW
WWFBFBFBFWW
WWFFFFFFFWW
WDFBFBFBFDW
WDFBFBFBFDW
WWFFFFFFFWW
WWFBFBFBFWW
WWFFFFFFFWW
WWFBFBFBFWW
WWFFFFFFFWW
WWWWWWWWWWW
WWWWWWWWWWW